accommodation - my accommodation 
conclusion - my conclusion
explanation - clear explenation
[]
actually - he's actually crazy
conscience - his conscience is good
February - February is the coldest month
[]
alcohol - if underaged, don't drink alchohol
conscious - he is conscious about his actions
fierce - fierce attack
[]
although - although john is mad at her,he... 
consequence - the consequences of his actions 
forty - forty chickens
[]
analyse - analyse the situation
analysis - Kowalski, analysis! 
continuous - it's a continuous spell
fulfil - fulfil your destiny
[]
argument - for argument's sake 
creation - human's creation
furthermore - you can't do that, furthermore...
[]
assessment - this is my assessment(please pass) 
daughter - my daughter is 10 years old
guard - keep your guard up
[]
atmosphere - there is no atmosphere in space 
decide - i must decide what i want
decision - i have to make a decision
happened - what happened here
[]
audible - i want to be audible 
definite - my word if definite
health - mental health
[]
audience - there is a big audience in the building
design - graphical design
height - his height is 190cm
[]
autumn - it's always rainy during autumn 
development - game development
imaginary - imaginary friend
[]
beautiful -  she's so beautiful 
diamond - the diamond is very expensive
improvise - i forgot the plan, so i had to improvise
[]
beginning - this is a new beginning
diary - dear diary/ i hate diary products
industrial - industrial revolution
[]
believe - i believe i can fly 
disappear - a magician is able to disappear in front of your eyes
interesting - the last theory was quite interesting
[]
beneath - beneath the earth	
disappoint - don't disappoint me
interrupt - he can't interrupt the teacher
[]
buried - he was buried alive 
embarrass - don't embarass her
issue - I have an issue
[]
business - business deal 
energy - sunlight energy
jealous - jealous boyfriend
[]
caught - caught on camera 
engagement - engagement ring
knowledge - blacksmithing knowledge
[]
chocolate - chocolate cake 
enquire - I must enquire you to do that
listening - listening to music
[]
climb - climb the tree 
environment - don't damage the environment
lonely - lonely evening
[]
column - row and column 
evaluation - evaluation test
lovely - lovely night
[]
concentration - the process requires concentration 
evidence - evidence of a crime
marriage - healthy marriage
[]
material - raw material 
potential - potential champion 
sincerely - sincerely yours,...
[]
meanwhile - meanwhile at home... 
preparation - preparation for the test
skillful - skillful chef
[]
miscellaneous - miscellaneous fruits
prioritise - prioritise school
soldier - he is a good soldier
[]
mischief - he did a mischief
process - complicated process
stomach - my stomach hurts
[]
modern - modern technology 
proportion - a small proportion
straight - straight out of the oven
[]
moreover - moreover of that
proposition - I have a proposition for you
strategy - strategy game
[]
murmur - he started to murmur
questionnaire - long questionnaire
strength - strength and honor
[]
necessary - do what is necessary
queue - I've been in a queue for quite a while
success - achieve success
[]
nervous - I'm very nervous
reaction - reaction video
surely - surely he'll understand
[]
original - original taste 
receive - receive a letter
surprise - surprise party
[]
outrageous - that's outrageous 
reference - reference number
survey - online survey
[]
parallel - parallel world 
relief - that was a big relief
technique - basketball technique
[]
participation - class participation 
remember - "remember, remember, the 5th of November"
technology - modern technology
[]
pattern - attack pattern 
research - research purposes
texture - texture detail
[]
peaceful - peaceful evening 
resources - gathering resources
tomorrow - tomorrow morning
[]
people - good people 
safety - safety first
unfortunately - unfortunately, bad things happen
[]
performance - slow performance 
Saturday - Saturday night
Wednesday - Wednesday afternoon
[]
permanent - permanent damage
secondary - secondary output
weight - heavy weight champion
[]
persuade - persuade him to talk
persuasion - the police use persuasion
separate - separate rooms
weird - weird attitude
[]
physical - physical health 
sequence - the films are in a sequence
women - women logic
[]
possession - possession of the ball 
shoulder - shoulder injury
